....................
......#########.....
....................
....................
......######........
......#.............
......#.............
....................
...............##...
....................
......#.............
......#.............
......#......###...
......#.............
......#######.......